10 10
**********
**....*.f*
*f..fff..*
*..**s*.f*
*..f.f**.*
*.**f....*
*...**.*.*
*f.*f..f.*
**....*f**
**********