15 15
***************
*.f...fff...f.*
*.fff.***.fff.*
*f***f...f***f*
*.f***fff***f.*
*.f.**fff**.f.*
*..f*******f.**
*..*f..*..f*..*
*....f.*.f....*
*..ff**f**ff..*
*.f**.f.f.**f.*
*.f**ff.ff**f.*
*.*ff.*.**ff*.*
*......s......*
***************