9 10
**********
*ffffffff*
**f*****f*
**f*****f*
**f*****s*
**f*****f*
**f*****f*
**ffff.ff*
**********