15 15
***************
*f.*********ff*
*..*********..*
*.*****s****..*
*.*****f*****.*
*.............*
*.............*
*.............*
*.............*
*.**********.**
*....******f..*
*f..f******.f.*
*f..f******f..*
*....**********
***************