10 9
*********
****f****
***f..ff*
*ff...ff*
*..****f*
*ff..**f*
*ff*.fff*
**f.s****
**fff****
*********
