7 7
*******
*f.f.f*
*.fff.*
**.s.**
*.fff.*
*f.*.f*
*******