7 7
*******
*s**.f*
*.....*
*.*f.**
*.f*..*
*f.*.f*
*******