15 15
***************
***....*......*
***.ff......f.*
*f.*ff.*.f.*..*
*..********...*
*..****f.**...*
*.....*..**...*
***....s....***
*...**..*.....*
*...**.f****..*
*...********.f*
*..*.f.*.ff****
*.f......ff.***
*......*....***
***************