7 15
***************
*ffff**ffff*.f*
*f..f*.....*f.*
*f**s..**f.**.*
*f**f**....**.*
*ffff**f.*....*
***************